2 5 1 1 2 0 0 0 -2 0 0 0 2 1 6 0 1 1 2
1 0 1 0 1 0 0 0 1 0 0 0 1 0 1 1 1 0 1
1 0 1 0 1 0 0 0 1 0 0 0 1 0 0 0 1 0 1
1 1 1 1 1 1 1 1 1 1 1 1 1 1 1 1 2 0 1
1 0 1 0 0 0 0 0 1 0 0 0 1 0 1 0 0 0 1
1 0 1 1 2 0 1 1 1 1 1 1 1 0 1 1 1 0 1
1 0 1 0 1 0 1 0 0 0 1 0 1 0 1 0 1 0 1
2 1 1 0 1 1 1 0 100 0 1 0 2 1 1 0 2 1 1
0 0 1 0 0 0 1 100 100 0 1 0 0 0 1 0 0 0 1
2 1 1 0 1 1 1 0 100 0 1 0 2 1 1 0 2 1 1
1 0 1 0 1 0 1 0 0 0 1 0 1 0 1 0 1 0 1
1 0 1 1 2 0 1 1 1 1 1 1 1 0 1 1 1 0 1
1 0 1 0 0 0 0 0 1 0 0 0 1 0 1 0 0 0 1
1 1 1 1 1 1 1 1 1 1 1 1 1 1 1 1 2 0 1
1 0 1 0 1 0 0 0 1 0 0 0 1 0 0 0 1 0 1
1 0 1 0 1 0 0 0 1 0 0 0 1 0 1 1 1 0 1
2 4 1 1 2 0 0 0 -3 0 0 0 2 1 3 0 1 1 2
